222222222222222222222222222222222222222222222222222
200000000000000000000000333333300000000000000000002
200000000000000000000000333333300000000000000000002
200000000000000000000000333333300000000000000000002
200000000000000000000000333333300000000000000000002
200000000000000000000000333333300000000000000000002
200000000000000000000000333333300000000000000000002
200000000000000000000000000000000000000000000000002
200000000000000000000000000000000000000000000000002
200000000000000000000000000000000000000000000000002
200000000000000000000000000000000000000000000000002
200000000000000000000000000000000000000000000000002
222222222222222222222222222222222222222222222222222