11111111111111111111
10000001111000001111
10000001111000001111
10004400000000440001
10004400000000440001
10004400000000440001
10004400000000440001
10000000000000000001
11111111111111111111